111111111111111111111111111111
1000000000000000000000000100E1
100000000000000000000000010011
100000000000000000000000010011
100000000000000000000000010011
100000000000000000000011110011
100000000000000000000100000011
10000000000000000000010000C011
100000000000000000000100111111
100000000000000000000100100001
100000000000000000000100100001
100000000000000000000100100001
1111111111100000000001C0100001
110000000001000000000100100001
110000000000111111111100100001
110111111100000000000000100001
1P0100000100000C00000000100001
111100000111111111111111000001
100000000000000000000000000001
111111111111111111111111111111
