111111111111111
100001C00000001
100001000000001
10C001000000001
100000001000001
100111100000001
10000C000000001
100000000000001
10000P0000000E1
111111111111111
