1111111111
1P00000001
100C0110E1
10000C0001
1111111111
