111111111111111111111111111111
1111111111111111111111110000E1
100000000000000000000010011111
100000000000000000011110010011
100000000000000000010000010011
100000000000000000010011110011
100111111110000000010100000011
10100000001000000001010000C011
10101000001111111111010C111111
10101000000C000C000C0100100001
101011111111111111111100100001
101000000000100000000100100001
1011111111001000000001C0100001
100000000100100000000100100001
100000000100111111111100000001
100000001000000000000000100001
111111110000000C00000000100001
1P0000000111111111111111000001
111111111000000000000000000001
111111111111111111111111111111
