11111111111111111111
10000000000000000E01
100000000010C0100001
100000C000100001C001
1P000000000000000001
11111111111111111111
