11111111111111111111111111111111111111111111
10000000000000000000000010000000000000000001
100000000010C01000000000100C0001C000111001E1
100000C000100001C000001000000001000011100111
1P000000000000000000011C000000000000111000C1
11111111111111111111111111111111111111111111
