11111111111111111111
1P100000001000000001
1000000000100C000001
1000000000000000C001
10111111111111111101
100000000000000C0001
10C00000000000C00001
10011100111000000001
10000C000000C00000E1
11111111111111111111
